WWWWWWWWWWWWWWW
W             W
W   b         W
W X  b X b  X W
W B     X    BW
W   b X X   b W
W     P       W
WWWWWWWWWWWWWWW 