WWWWWWWWWWWWWWW
W         X   W
W  b  P   b   W
W X        X  W
W B  b    b B W
W         X   W
WWWWWWWWWWWWWWW  